/------------T------------/
|o           |           o|
| /--/ /---/ | /---/ /--/ |
| |..| |...| | |...| |..| |
| /--/ /---/ | /---/ /--/ |
|                         |
| ---- ------T------ ---- |
|            |            |
| |     ---- | ----     | |
| /----             ----/ |
|       /---   ---/       |
| /---/ |         | ----- |
| |...| /---------/       |
| /---/      p      /- -/ |
|       ----------- |   | |
| | | |             |   |o|
/-T-T-T-------------T---T-/

