/------------T------------/
|            |            |
| /--/ /---/ | /---/ /--/ |
| |  | |   | | |   | |  | |
| /--/ /---/ | /---/ /--/ |
|                         |
| ---- ------T------ ---- |
|            |            |
| |     ---- | ----     | |
| /----             ----/ |
|       /---   ---/       |
| /---/ |         | ----- |
| |   | /---------/       |
| /---/      p      /- -/ |
|       ----------- |   | |
| | | |             |   | |
/-T-T-T-------------T---T-/

