1111111111111111111111111111
1000000000000000000000000001
1011110111110111110111110101
1020000100000100000100000201
1011110111110111110111110101
1000000000000000000000000001
1011110110111111111011011101
1000000100100000001001000001
1111110110111111111011011111
0000010100000000000000101000
1111010110111111111011010111
1000000100100000001001000001
1011110110111111111011011101
1020000000000000000000000201
1011110110111111111011011101
1000000100100000001001000001
1111110110111111111011011111
1000000000100000001000000001
1011111110111111111011111101
1000000000000000000000000001
1011110111110111110111110101
1020000100000100000100000201
1011110111110111110111110101
1000000000000000000000000001
1111111111111111111111111111