/------------T------------/
|o           |           o|
| /--/ /---/ | /---/ /--/ |
| |..| |...| | |...| |..| |
| /--/ /---/ | /---/ /--/ |
|                         |
| ---- ------T------ ---- |
1            |            0
| |     ---- | ----     | |
| /----             ----/ |
|       | --- --- |       |
| /---/ | b  c n i| ----- |
| |...| /---------/       |
| /---/      p      /- -/ |
|       ----------- |   | |
| | | |             |   |o|
/-T-T-T-------------T---T-/